.................
.0................
..3############...
..3#..........#...
..3#..........#...
..3#..........#...
..3#G.........#...
..3#..............
..3#..............
..3#..............
..3#..............
..3#..............
..3XXXXXXXXXXXXX..
..3XXXXXXXXXXXXX..
..33333333333333..
..33333333333333..
..................