############
#0.........#
#..####....#
#..#.......#
#..33333...#
#..XXXXX...#
#..XXXXX#..#
#XXX....#..#
##..#..G#..#
#...X...#..#
#..........#
############