............
.0..........
..3######...
..3#....#...
..3#....#...
..3#....#...
..3#G.......
..3XXXXX....
..3XXXXX....
..333333....
