..........
.0........
...####...
...#.G....
...33333..
...XXXXX..
..........